# Sources: Freebase, GUM, added data by Amir Zeldes (see licenses)
%	quantity
1	time
100000	quantity
11-Sep	event
12	time
1890	time
1906	time
1960s	time
1969	time
1970	time
1970s	time
1987	time
1989	time
1994	time
20	quantity
2000	time
2002	time
2005	time
2006	time
2007	time
2008	time
2009	time
2010	time
2011	time
2014	time
2015	time
2050	time
213	place
23	time
24	quantity
25	quantity
2Pac	person
3	quantity
34th	abstract
4th	event
5	quantity
60000	quantity
747	object
9	time
A	object
a	organization
aardvark	animal
abbess	person/female
abbot	person/male
abilities	abstract
able	abstract
about	quantity
academic	abstract
academician	person
Accident	abstract
accordionist	person
accountant	person
accouterments	object
acfor	person
achievements	abstract
Acphillips	person
acquaintance	person
Act	object
action	event/inanim
actions	abstract
activist	person
activity	abstract
actor	person
actor-manager	person
actors	person
actress	person
actriz	person
actuary	person
acupuncturist	person
ad	abstract
Adams	person
addition	event
adjudicator	person
adjusters	object
administration	organization
administrator	person
admiral	person
ads	abstract
adults	person
advantages	abstract
adventurer	person
advertising	abstract
adviser	person
advocate	person
aerialist	person
affenpinscher	animal
affiliate	person
affineur	person
agency	organization
agenda	abstract
agent	person
ago	time
agrarian	person
agriculturalist	person
agriculture	abstract
agriculturist	person
agronomist	person
aid	abstract
aioli	substance
air	abstract
airline	organization/inanim
airliner	organization/inanim
airman	person
airport	place
airports	object
alchemist	person
all	abstract
alligator	animal
Allton	person
almanac	object
Almanac	organization
almoner	person
alpaca	animal
Alphabet	abstract
alphabets	abstract
alt.religion.scientology	place
am	time
ambassador	person
ambiguity	abstract
amendment	abstract
amenities	place
America	place
amount	quantity
amphibian	animal
analysis	abstract
analyst	person
Analytics	abstract
anarchy	abstract
anatomist	person
anatomy	abstract
and	object
andrillae	animal
anemone	animal
anemones	animal
anesthesiologist	person
Angelou	person
Angels	organization
anger	abstract
animal	animal
animals	animal
animator	person
anniversary	event
anniversay	event
announcement	abstract
announcer	person
annuals	plant
Anonymous	person
another	place
answers	abstract
ant	animal
Antarctic	place
Antarctica	place
antarctician	person
anteater	animal
antelope	animal
anthropologist	person
antiquarian	person
anyone	person
anything	object
apartment	place/inanim
ape	animal
Aphrodite	person
API	abstract/inanim
apostle	person
apothecary	person
appearance	abstract
appliances	object
applying	event
appraiser	person
approach	abstract
Apr.	time/inanim
April	time
aquanaut	person
Arabic	abstract
arabist	person
arachnologist	person
arborist	person
arbovirologist	person
archaeologist	person
archbishop	person
archeologist	person
archimandrite	person
architect	person
architecture	object
archivist	person
Area	place
areas	place
Arena	place
argali	animal
ariegeois	animal
arm	object/inanim
armadillo	animal
around	person
arranger	person
Arrogance	abstract
arrogant	person
arrow	object/inanim
art	abstract
article	object
articles	abstract
artifacts	object
artisan	person
artist	person
arts	abstract
as	place
askari	person
aspects	abstract
assassin	person
assayer	person
assistance	abstract/inanim
association	organization/inanim
assyriologist	person
astrobiologist	person
astrologer	person
astronaut	person
astronauts	person
astronomer	person
astrophysicist	person
At	time
Athena	person
athlete	person
Atlantis	object
atmosphere	abstract
atolls	place
attach√©	person
attack	event
attack	event/inanim
attacked	event
attacks	abstract
attempt	event
attempts	event
attendees	person
attention	event
attic	place
attitude	abstract
attractions	abstract
auctioneer	person
audiences	person
audiologist	person
auditor	person
Aug.	time/inanim
aunt	person/female
Australia	place
author	person
authorities	organization
autograph	object
Avai\'o\'vuna	place
Ave	place
Avenue	place
aviatio	abstract
aviation	abstract
azawakh	animal
b-boy	person
baboon	animal
baby	person/female
baby	person/male
babysitter	person
back	object
backer	person
background	abstract
bacteria	animal/plural
bacteriologist	person
bacterium	animal
badger	animal
bag	object
bags	object
bailiff	person
baker	person
Balisage	event/inanim
balloonist	person
balloons	object
ballot	object
balloting	event/inanim
ballpark	place/inanim
ban	event/inanim
band	organization
bandleader	person
bandog	animal
bandurist	person
banguela	animal
bank	organization/inanim
bank	place/inanim
banker	person
banks	place
banner	object
barber	person
barbet	animal
bard	person
bargirl	person
barista	person
bark	substance
baron	person
barrier	object
barrister	person
BART	organization
bartender	person
Base	place
base	place/inanim
baseball	abstract
baseline	abstract
basenji	animal
basil	plant
basils	plant
basketball	abstract
bassist	person
bassoonist	person
bat	animal
batter	object
battle	event
Bay	object
bay	place/inanim
bays	place
beach	object
beaches	place
beader	person
beadle	person
beagador	animal
beagle	animal
beagle-harrier	animal
beamter	person
bear	animal
bear-leader	person
beasts	animal
beauceron	animal
beautician	person
beaver	animal
bedder	person
bee	animal
beekeeper	person
beetle	animal
beetles	animal
behalf	abstract
bellhop	person
bellman	person
belt	place
bencher	person
benefactor	person
benefits	abstract
benshi	person
best	abstract
better	abstract
Between	time
Bever	abstract
Bevernondelibreatekin	abstract
biathlete	person
bib	object
bibliographer	person
bibliophile	person
bicycle	object/inanim
bike	object/inanim
bill	place
biochemist	person
bioengineer	person
bioethicist	person
biographer	person
bioinformatician	person
biologist	person
biologists	person
biometrician	person
biophysicist	person
biostatistician	person
biotechnician	person
Bird	animal
Birdie	person
Birdman	person
Birds	abstract
birthplace	place
bisben	animal
bishop	person
bison	animal
bit	quantity/inanim
bits	object
black	abstract
blacksmith	person
blankets	object
blender	object
blogger	person
bloodhound	animal
blouses	object
Blvd	place
board	object
board	organization
boat	place
boatman	person
boats	object
boatwright	person
bobsleigher	person
body	object/inanim
bodybuilder	person
bodyguard	person
boerboel	animal
Bolden	person
bolonka	animal
bondbroker	person
bonecarver	person
bonesetter	person
book	object
bookbinder	person
bookcase	object/inanim
bookkeeper	person
bookkeeping	abstract
bookmaker	person
bookseller	person
bookstores	place
booster	person
booths	object
bootseller	person
border	place
borzoi	animal
boss	person
botanist	person
both	place
botonist	person
bottle	object
bottles	object
bottom	place
bottoms	object
bouncer	person
bouquet	object/inanim
boutiques	place
bow	event
bowl	object/inanim
bowler	person
bowyer	person
box	object
boxer	animal
boxes	object
boy	person/male
boyfriend	person/male
boys	organization
brain	abstract
brain	object
Braysmith	person
break	event/inanim
breakfast	event/inanim
breeder	person
brewer	person
brewmaster	person
briard	animal
bricklayer	person
brickmaker	person
bridge	place
brigadier	person
broadcaster	person
Broadway	place
broker	person
bronze	object
bronzefounder	person
brother	person
Brotherhood	organization
Browns	organization
browser	object
browsers	object
brug	animal
buccaneer	person
Budd	person
Buddhism	abstract
budgerigar	animal
budget	abstract
budgets	abstract
buds	plant
bugs	object
builder	person
building	abstract
Building	place
buildings	place
built	abstract
bulk	abstract
bull	animal
bull-boxer	animal
bulldog	animal
bullet	object
bullmastiff	animal
bullocky	person
bunch	person
bureaucrat	person
burgers	object
burglar	person
bursar	person
bus	object
buses	object
bushes	plant
bushranger	person
business	abstract
business	event
businessperson	person
busker	person
butcher	person
butler	person
butter	substance/inanim
butterfly	animal
buttero	person
buyer	person
buying	abstract
buzzard	animal
buzzwords	abstract
by	time
cable	object/inanim
caddie	person
caddy	person
cafe	place
cafes	place
cakes	object
calf	animal
call	event/inanim
caller	person
calligrapher	person
camel	animal
camera	object
cameras	object
camgirl	person
campaign	abstract
Canada	place
Canaveral	place
cancer	abstract/inanim
candidate	person
candidates	person
candies	substance
candlemaker	person
candy	object
cans	object
cantor	person
capitalism	abstract/inanim
Capote	person
capsules	object
captain	event
capybara	animal
car	object/inanim
carabinier	person
carcinologist	person
card	object/inanim
cardinal	person
Cardinals	organization
cardiologist	person
career	abstract
caregiver	person
caribou	animal
caricaturist	person
Carnival	event
carny	person
carpenter	person
cart	object
cartographer	person
cartoonist	person
cartwright	person
case	abstract/inanim
cases	object
caseworker	person
Casnondelibreaten	abstract
castellan	person
cat	animal
catechist	person
caterer	person
caterers	place
Cathedral	place
cattle	animal
causes	abstract
Cavalcade	event
Cavaliers	organization
cavalry	person
cavalryman	person
cavapoo	animal
caver	person
celebrities	person
celebutante	person
cell	object/inanim
cell	place/inanim
cellist	person
census	event/inanim
center	place/inanim
centre	place/inanim
century	time/inanim
CEO	person
ceramist	person
Cereal	object
ceremony	event
chairman	person
chairwoman	person/female
Challenger	object
chamber-maid	person
chamberlain	person
chameleon	animal
chamois	animal
Championship	event
change	abstract
Change	organization
chansonnier	person
chantilly-tiffany	animal
chaplain	person
chapmen	person
character	abstract
character	person
characters	person
charge	abstract/inanim
charioteer	person
charities	organization
charm	abstract
chart	object
charwoman	person
chauffeur	person
check	event/inanim
check	object/inanim
cheerleader	person
cheesecloth	object
cheetah	animal
chef	person
chemicals	object
chemist	person
chemistry	abstract
chicken	animal
chihuahua	animal
child	person
children	person
chimpanzee	animal
China	place
Chinatown	place
chinchilla	animal
Chinese	abstract
chinook	animal
chipmunk	animal
chippiparai	animal
chiropractor	person
chocolate	substance
chocolatier	person
choice	abstract
choices	abstract
choreographer	person
Chrome	object
chronicler	person
chrysotile	substance
Church	organization
church	place/inanim
churchman	person
cider	substance
cigarette	object/inanim
cinematographer	person
Cinnamon	object
circle	abstract
Circle	organization
circumstances	abstract
circus	organization
circus	place
citral	plant
City	place
civility	abstract
claim	abstract/inanim
clam	animal
clarinetist	person
class	abstract
classicist	person
cleaner	person
cleanup	abstract
clergy	person
cleric	person
clerk	person
Cleveland	place
click	event/inanim
Cliffs	place
climate	abstract
climatologist	person
climber	person
clinic	place/inanim
clinician	person
clockmaker	person
clones	abstract
Close	person
close	time
cloth	object
clothes	object
clothier	person
clothing	object
clown	person
club	object/inanim
club	place/inanim
co-founder	person
co-producer	person
coach	person
coachman	person
coauthor	person
COBOL	abstract/inanim
cobra	animal
cockapoo	animal
cockatiel	animal
cockroach	animal
cocktails	object
cocoa	substance
Code	object
coffeehouses	place
cofferer	person
coiner	person
cold	abstract
collaboration	abstract/inanim
collaboration	event
collarbone	object/inanim
colleagues	person
collection	abstract
Collections	abstract
college	organization
college	place
colonel	person
color	abstract
colorist	person
colors	abstract
colt	animal
Columbia	object
columbidae	animal
columnist	person
combai	animal
combination	abstract
Comeback	event
comedian	person
comedy	abstract/inanim
command	abstract/inanim
commentator	person
commissar	person
Committee	organization
commodore	person
commoner	person
Commons	organization
commonwealth	place
community	organization
companies	organization
company	organization
comparisons	abstract
compasssmith	person
compatibility	abstract
compete	abstract
competition	abstract/inanim
competition	organization/inanim
compiler	abstract/inanim
Complex	place
complication	abstract
composer	person
composition	abstract
compositor	person
compound	abstract/inanim
compound	place/inanim
compound	plant
compound	substance/inanim
computer	object/inanim
computers	organization
concentration	animal
concept	abstract
concertmaster	person
concerts	event
concierge	person
conclusion	event
condemnation	abstract
condition	abstract
condottiere	person
conductor	person
conference	event/inanim
conferencier	person
conflict	event
congestion	abstract/inanim
connector	object/inanim
connoisseur	person
connotation	abstract
conquistador	person
consensus	abstract
conservationist	person
conservator-restorer	person
consort	person
constable	person
constraints	abstract
consul	person
consultant	person
consultor	person
consumption	abstract
contact	abstract/inanim
contact	person
container	object
containers	object
contamination	abstract
content	abstract
contents	object
context	abstract/inanim
contortionist	person
control	abstract/inanim
controller	object/inanim
controller	person
Convention	event
conversations	event
conveyancer	person
cook	person
cookie	object
coonhound	animal
cooper	person
cop	person
coppersmith	person
copyist	person
copyright	abstract
copywriter	person
core	place
corgi-chihuahua	animal
cormorant	animal
corn	plant
cornerman	person
cornetist	person
Cornyn	person
coroner	person
corpora	abstract/inanim
corporation	organization/inanim
corporatism	abstract
corpus	abstract/inanim
corrector	person
corsetmaker	person
corvus	animal
cosmetics	person
cosmetologist	person
cosmologist	person
cossack	person
cost	quantity/inanim
costermonger	person
costumer	person
cotton	plant
cougar	animal
councillor	person
counsellor	person
counselor	person
Countdown	place
counter	place
counterpart	abstract
counterpart	person
country	place
County	place
courier	person
course	abstract/inanim
courses	place
court	organization
courtesan	person
courtier	person
couturier	person
covariation	abstract
cover	abstract
cover	object
cowboy	person
coxswain	person
coyote	animal
crab	animal
crane	animal
cream	place
creation	substance
creations	object
creature	animal
creature	person
crew	person
crewman	person
cricketeer	person
cricketer	person
criminal	person
criminologist	person
critic	person
Critics	person
crocidolite	substance
crocodile	animal
cronista	person
cronyism	abstract
crop	plant
crops	plant
crossbowyer	person
cruel	event
Cruise	person
cryptographer	person
cryptologist	person
cryptozoologist	person
crystallographer	person
cto	person
Cuccinelli	person
cuillerer	person
cuisine	abstract
culture	abstract
Cup	event
cupcake	object
cupcakes	object
Cups	event
curator	person
curiosity	abstract/inanim
curler	person
currier	person
custodian	person
customers	person
customs	object
cutman	person
cyberneticist	person
cycle	abstract
cycles	event
cyclone	event/inanim
cytogeneticist	person
dachshund	animal
dad	person/male
daddy	person/male
Daily	organization/inanim
daimyo	person
dairymaid	person
Dallas	place
dalmatian	animal
Daly	person
damage	abstract
damchi	animal
dance	abstract
dancer	person
data	abstract/inanim
database	object
datajournalist	person
date	time
daughter	person/female
day	time
dayan	person
days	time
deacon	person
deal	abstract
dealer	person
death	event
debate	abstract/inanim
debate	event/inanim
Dec.	time/inanim
decade	time
decades	time
December	time
decision	abstract
declares	event
decommissioning	event
decrease	event/inanim
deejay	person
deer	animal
defendant	person
defender	person
defterdar	person
degree	quantity/inanim
degu	animal
deities	abstract
deli	place
delicious	quantity
demand	abstract
demo	abstract/inanim
Democrats	person
demographer	person
demolitionist	person
denomination	organization
dentist	person
Department	organization
dermatologist	person
designer	person
destroyer	object/inanim
destroyer	person
destruction	event/inanim
detail	abstract/inanim
detailhandler	person
detective	person
detergent	substance
developers	person
development	abstract
development	place
device	object/inanim
dhalang	person
diamantaire	person
diaper	object
diarist	person
dictionary	object
didgeridooist	person
diet	event
dietitian	person
difficulties	abstract
digerati	person
digits	event
dingo	animal
dining	place
dinner	event/inanim
dioxide	abstract
diplomat	person
director	person
disadvantages	abstract
disaster	event/inanim
disciple	person
discovery	object
dishes	abstract
dishwasher	object
disk	object/inanim
dispatcher	person
displayed	place
displays	object
distiller	person
distribution	abstract/inanim
District	place
divemaster	person
diver	person
diversity	abstract
dj	person
DNA	abstract
documentalist	person
documentation	abstract
documents	object
dog	animal
dogcatcher	person
dollar	quantity/inanim
dominatrix	person
donation	abstract
donkey	animal
donors	person
door	object/inanim
dorgi	animal
dormouse	animal
doshu	person
doula	person
down	abstract
downtown	place
doxographer	person
dozen	quantity
drafter	person
draftsman	person
dragoman	person
dragoon	person
dramaturge	person
dramaturgist	person
draws	abstract
drayman	person
dress	object
dresser	person
dresses	object
dressing	abstract
dressmaker	person
drever	animal
driller	person
Drink	abstract
drink	object
drink	substance
drive	event/inanim
driver	person
dromedary	animal
droughts	event
drover	person
druid	person
drummer	person
dryer	object
drywaller	person
dubber	person
dubbing	person
duchess	person
duck	animal
Dunbar	person
dunker	animal
durability	abstract
Duran	organization
Durham	place
during	time
e-tutor	person
each	abstract
eagle	animal
earlier	time
earthquake	event
earthquakes	event
easier	object
ecologist	person
economics	abstract
economist	person
economy	abstract
ecosystem	abstract
Edgewater	place
edit	event/inanim
editor	person
editors	person
educationalist	person
educator	person
eel	animal
effect	abstract
effectiveness	abstract
effects	abstract
effort	abstract
efforts	event
eggs	object
egyptologist	person
eHow	place
either	abstract
elder	person
election	event
electrician	person
electron	substance/inanim
element	abstract
Elements	abstract
elk	animal
elo	animal
email	abstract/inanim
emailing	person
embroiderer	person
emissions	abstract
employee	person
employees	person
empty	object
end	event
Endeavour	object
endocrinologist	person
endodontist	person
energy	abstract
engineer	person
engines	object
England	place
English	abstract
engraver	person
enologist	person
Enterprise	object
entertainer	person
entertainment	abstract
entomologist	person
entrance	place
entremetteuse	person
entrepreneur	person
entry	place
environment	place
environmentalist	person
enzymologist	person
epidemiologist	person
epigrapher	person
episode	abstract
epistemologist	person
equestrian	person
equidae	animal
equipment	object
era	time
Erie	place
esotericism	person
essayist	person
essentials	object
establishments	place
esthetician	person
ethicist	person
ethnobotanist	person
ethnographer	person
ethnologist	person
ethnomusicologist	person
ethologist	person
etudiante	person
etymologist	person
euphoniumist	person
eurasier	animal
Eureka	place
eurohound	animal
evangelist	person
Evans	person
Evanston	place
Evansville	place
evening	object
event	abstract/inanim
event	event
events	event
everything	object
everywhere	place
evil	abstract
evolution	abstract
example	abstract
examples	abstract
executioner	person
executive	person
exercise	abstract/inanim
exercise	event/inanim
exhibit	event
exhibited	event
exhibition	event
exhibitionist	person
exhibits	event
exile	person
exodontist	person
exoplanetologist	person
expat	person
expatriate	person
expectation	abstract/inanim
experience	abstract
Experience	place
experiences	abstract
experiment	event/inanim
expert	person
explorer	abstract
Explorer	object
explorer	person
exposure	abstract
expressman	person
extent	abstract
exterminator	person
extra	person
extract	substance
extremism	abstract
extremist	person
eye	object/inanim
fabricator	person
face	object
facilities	place
fact	abstract
factor	abstract/inanim
Factory	place
factory	place/inanim
failure	abstract
faith	abstract
falcon	animal
fallout	substance
fame	abstract/inanim
family	person
fan	object/inanim
fan	person
fans	person
farmer	person
farmworker	person
farrier	person
fascination	abstract
fashion	abstract
fasteners	object
fear	abstract
feat	event
features	abstract
Feb.	time/inanim
February	time
fee	abstract/inanim
feedback	abstract/inanim
feeling	abstract
feldsher	person
felidae	animal
fellmonger	person
fellow	person
feltmaker	person
fence	person
ferret	animal
ferry	object
festival	event
few	object
fewer	quantity
FFFF	event
fiddler	person
field	abstract/inanim
field	place/inanim
fields	abstract
file	object/inanim
film	object
filmmaker	person
filter	object
finance	abstract
financier	person
finch	animal
findings	abstract
Finkelstein	person
fire	abstract/inanim
firearm	object/inanim
fireater	person
firefighter	person
Firefox	object
fireman	person
fireworks	event
firm	organization
fish	animal
fisherman	person
fishmonger	person
fixing	event/inanim
flagman	person
flamingo	animal
flash	object
flats	object
flatulist	person
flavor	abstract
flavor(s)	abstract
flavoring	event
flavorist	person
flavors	abstract
flavour	abstract
flaws	abstract
fleet	object
flight	event
flight-adjutant	person
flmi	person
floods	event
florist	person
flour	substance
flow	abstract
flower	plant
fluffer	person
fluid	substance
flutist	person
foa	animal
foal	animal
folklorist	person
folks	person
follow	event
food	substance
foodies	person
footage	abstract
football	abstract/inanim
footman	person
forager	person
force	abstract/inanim
foreigners	person
foreman	person
forest	place/inanim
forester	person
form	abstract
formalin	substance
format	abstract
fortress	place/inanim
found	abstract
foundation	organization
founder	person
fox	animal
Fox	place
Franciscans	person
Francisco	place
Frank	person
freedom	abstract
freelancer	person
freezer	object
French	abstract
friar	person
Friday	time
fridge	place
friend	person
friends	person
friendships	abstract
frog	animal
frogman	person
From	time
frost	event
frosting	object
fruit	substance
fugitive	person
fun	abstract/inanim
funnel	object/inanim
furrier	person
fusilier	person
future	abstract
futurist	person
g	quantity
gaffer	person
Gagarin	person
gal	person/female
gal	quantity/inanim
galleries	place
gallery	place
gals	person
gambist	person
gambler	person
game	abstract
gamekeeper	person
gamer	person
games	event
gaming	abstract/inanim
gangster	person
gap	time
garb	object
garden	place
gardener	person
gardeners	person
gaucho	person
gazelle	animal
geheimrat	person
geisha	person
gemcutter	person
gemsbok	animal
genders	abstract
genealogist	person
General	person
generalissimo	person
genes	abstract
geneticist	person
genome	abstract
gensaku-sha	person
geochemist	person
geodesist	person
geographer	person
geologist	person
geologists	person
geometer	person
geophysicist	person
gerbil	animal
German	abstract
germanist	person
gerontologist	person
Gerulaitis	person
gharial	animal
ghostwriter	person
gift	object
Gigaloader	object
gigolo	person
giraffe	animal
girl	person/female
girlfriend	person/female
Gish	person
glaciologist	person
gladiator	person
glass	object
glassblower	person
glasses	object
glazier	person
Gliders	organization
Globe	plant
globemaker	person
glove	object/inanim
glovemaker	person
glow	abstract
glowstick	object/inanim
glut	abstract
glycobiologist	person
GMT	time
goal	abstract
goalkeeper	person
goals	event
goat	animal
goatherd	person
gods	abstract
goers	person
goldendoodle	animal
goldsmith	person
golfer	person
gondolier	person
goods	object
goose	animal
gorilla	animal
governess	person
government	organization/inanim
government	organization/plural
Governor	person
Governor(s)	person
governors	person
gram	quantity/inanim
grammar	abstract
grammarian	person
gramps	person/male
Grand	place
grandfather	person/male
grandma	person/female
grandmother	person/female
grandpa	person/male
grape	abstract
graphic	object/inanim
grazier	person
Greeks	person
green	abstract
greengrocer	person
Greensboro	organization
greensman	person
greeting	event
Gregoire	person
grenadier	person
greyhound	animal
griot	person
grip	object
grip	person
grocer	person
groenendael	animal
groom	person
groomer	person
groundskeeper	person
group	abstract
growth	plant
guanaco	animal
guarantee	abstract/inanim
guide	object
guide	person
guidelines	abstract/inanim
guitarist	person
gull	animal
gun	object
gunfighter	person
gunpowder	substance/inanim
gunsmith	person
guru	person
Gustafon	person
guy	person/male
gymnast	person
gymterneter	person
gynecologist	person
haberdasher	person
hacker	person
Hackers	person
hagfish	animal
hairdresser	person
Hall	place
halls	place
Halston	person
Hamill	person
hamiltonst√∂vare	animal
hamster	animal
handle	quantity
handling	abstract
hands	object
handyman	person
hangar	place
Hanks	person
happening	event
happy	event
harbour	place
hare	animal
harpist	person
harpsichordist	person
harrier	animal
hartebeest	animal
hatter	person
havanese	animal
have	event
haven	place
having	event
hawk	animal
hawker	person
Hawthorne	place
hayward	person
hazzan	person
head	object
head	person
headmaster	person
heads	plant
Heagle	person
Heald	person
HealthSpace	place
heat	substance
heaven	place
hebraist	person
hedgehog	animal
height	quantity
heilpraktiker	person
helpmate	person
hematologist	person
hematopathology	person
her	person
Hera	person
Herald	organization
herald	person
heraldry	person
herb	plant
herbalist	person
herder	person
here	place
hermit	person
heron	animal
herpetologist	person
Herrick	person
hetaira	person
hieromonk	person
highlights	place
highrise	place
highwayman	person
Hill	person
hill	place
hills	object
hip	abstract
hippopotamus	animal
hipster	abstract
hiring	abstract
hispanist	person
historian	person
history	abstract
hit	abstract
hitman	person
hobby	abstract
hobo	person
holder	person
holders	object
holes	object
holiday	time
home	place
homebrewing	person
homemaking	person
homeopath	person
homepage	place
homes	place
Hopper	person
hornet	animal
hornist	person
horologist	person
horror	abstract
horse	animal
horticulturalist	person
horticulturist	person
hostler	person
hotel	place/inanim
hour	time
hours	time
house	place
houseboy	person
housekeeper	person
housemaster	person
houses	place
houseware	object
Houston	place
hovawart	animal
hub	place
Huebi	person
humanitarian	person
hummingbird	animal
humorist	person
humpbacks	animal
huntaway	animal
hunter	person
Huntsville	place
husband	person/male
husbandman	person
hydraulist	person
hydrogen	substance/inanim
hydrogeologist	person
hydrographer	person
hyena	animal
hygenhund	animal
hymnist	person
hymnology	person
hypnotherapist	person
hypnotist	person
ibex	animal
ice	substance
ichthyologist	person
icing	object
idea	abstract
identification	abstract
IE	object
IE6	object
iguana	animal
Illinois	place
illusionist	person
illustrator	person
image	object
images	object
imagination	abstract
imagineer	person
imam	person
immigrant	person
immunologist	person
impacts	abstract
impala	animal
imperfection	abstract
imperfections	abstract
impersonator	person
importance	abstract
impostor	person
impresario	person
impression	abstract
impressionist	person
improvement	abstract
improviser	person
in	place
Inc.	organization/inanim
incentive	abstract
incident	event
increases	event
Indians	organization
individuals	person
indologist	person
industrialist	person
industriemechaniker	person
industry	abstract
inferiors	person
infielder	person
influence	abstract
influences	abstract
informant	person
informatica	person
information	abstract
Ingram	person
ingredients	substance
inker	person
innkeeper	person
input	abstract
insides	quantity
inspector	person
installation	abstract/inanim
Institute	organization
institutions	organization
instructions	abstract
instructor	person
insurer	person
insurgency	organization
insurgent	person
intellectual	person
intelligence	abstract
intendant	person
interaction	abstract
interest	abstract
interface	abstract/inanim
Internet	abstract
internist	person
interpreter	person
interrogator	person
Interview	event
inventor	person
investor	person
invitation	event
irishjacks	animal
ironmaster	person
ironmonger	person
ironworker	person
is	abstract
Island	place
islands	place
isle	place/inanim
issue	abstract
issues	abstract
Italy	place
item	object
items	object
its	place
j√§mthund	animal
Jack	person
jackal	animal
jackaroo	person
Jackson	person
jagdterrier	animal
jaguar	animal
jail	place/inanim
jailer	person
Jake	place
Jan.	time/inanim
janitor	person
January	time
Jealousy	abstract
jeans	object
jellyfish	animal
jerboa	animal
Jersey	place
jester	person
jeweler	person
jeweller	person
JFK	place
job	abstract
jockey	person
John	person
joiner	person
jolt	event/inanim
jonangi	animal
journal	object
journalist	person
journey	event
journeyman	person
JP	person
JSC	place
Jubilee	event
judge	person
jug	object
juggler	person
juice	substance
July	time
July	time/inanim
junction	place/inanim
June	time
June	time/inanim
junk	object
junkyard	place
jurist	person
justiciar	person
kaikadi	animal
kangaroo	animal
kanni	animal
kannushi	person
kapellmeister	person
karakachan	animal
kar\u014d	person
kaymakam	person
keep	event
keeshond	animal
Kennedy	place
keys	abstract
keytarist	person
khatib	person
Khincasnonbever	abstract
Khinssa	abstract
Khinssacasnondelibreatenibever	abstract
kickback	abstract/inanim
Kids	person
kind	substance
kinesiologist	person
kinkajou	animal
kintamani	animal
kishu	animal
kit	object/inanim
kitten	animal
knacker	person
knifegrinder	person
knifesmith	person
knight	person
knight-errant	person
knocker-up	person
Know	abstract
know	organization
knowledge	abstract
koala	animal
koi	animal
komondor	animal
kooikerhondje	animal
koolie	animal
kromfohrl√§nder	animal
KSC	place
kudu	animal
kuri	animal
kuvasz	animal
kyi-leo	animal
l√∂wchen	animal
laboratory	place
laborer	person
laborers	person
lack	quantity
lackey	person
lady-in-waiting	person
laekenois	animal
laity	person
Lake	place
lakefront	place
Lakeshore	place
lama	person
lamb	animal
lamplighter	person
land	abstract
landholder	person
landlord	person
landscaper	person
landseer	animal
lane	place/inanim
language	abstract
Language	object
languages	abstract
lap	abstract
lapses	abstract
largest	object
lark	animal
laryngologist	person
launch	abstract
launchpads	place
law	abstract/inanim
lawman	person
laws	abstract
Lawsuits	abstract
lawyer	person
layman	person
leader	person
leadership	abstract
leadman	person
leadworker	person
leaf	plant
learning	abstract/inanim
leaves	plant
lector	person
lecturer	person
lee	place
left	abstract
leg	object/inanim
legacy	abstract
legion	organization/inanim
legislation	abstract/inanim
legislator	person
legislators	person
legislature	organization
lehrer	person
lemur	animal
length	quantity/inanim
leonberger	animal
Leonia	place
leopard	animal
lepidopterist	person
leporids	animal
letter	abstract
letter	object
letterer	person
letters	abstract
level	abstract
levels	abstract
lexicographer	person
Libertarian	person
Libertarians	person
liberty	abstract
librarian	person
librettist	person
License	abstract
licensee	person
lid	object
lieutenant	person
life	abstract/inanim
lifecaster	person
lifeguard	person
lifetime	abstract
liftoff	event
liger	animal
light	abstract
light	abstract/inanim
lights	abstract
lightworker	person
liliger	animal
lime	abstract
limits	abstract
limner	person
line	place
lineman	person
linguist	person
lion	animal
lipizzan	animal
list	object
lists	abstract
liter	quantity
lithographer	person
Live	place
lives	abstract/inanim
lizard	animal
llama	animal
llanero	person
lobbyist	person
lobster	animal
local	person
localities	place
locals	person
location	place
locations	place
locksmith	person
logger	person
logician	person
London	place
look	abstract
loss	event
lot	abstract
lots	object
Louis	place
louse	animal
lovebird	animal
luck	abstract/inanim
luger	person
lumberjack	person
lumbricidae	animal
luminescence	abstract
luminol	substance/inanim
lunch	event/inanim
lutenist	person
luthier	person
lynx	animal
lyricist	person
macaque	animal
machine	object
machineworker	person
machinist	person
macropodidae	animal
mafioso	person
magasinier	person
magazine	organization
magazines	object
Magazines	organization
magic	abstract
Magic	place
magician	person
magicians	person
magistrate	person
magnate	person
magnification	quantity
magpie	animal
mahout	person
maid	person
maids	person
maintenance	abstract
maize	plant
majordomo	person
make	event
maker	organization
maker	person
male-nurse	person
malinois	animal
mallard	animal
maltepoo	animal
mama	person/female
man	person/male
man-servant	person
management	organization/inanim
management	person
manager	person
manatee	animal
manciple	person
mandolinist	person
mandrill	animal
manga	abstract
mangaka	person
Manhattan	place
manicurist	person
mantero	person
manual	object
manufacturer	organization/inanim
manufacturer	person
many	person
Many	place
map	object
Mapplethorpe	person
Mar.	time/inanim
marbler	person
March	time
mare	animal
Marilyn	person
market	abstract/inanim
market	place/inanim
marketeer	person
marketer	person
marketing	person
markets	place
marks	abstract
marksman	person
marmoset	animal
marquess	person
marriage	abstract
marten	animal
Marv	person
mason	person
masseur	person
master	person
mastinaro	animal
matbennett	person
material	abstract
materials	substance
mathematician	person
matron	person
Mauer	person
Maurer	person
May	time/inanim
mayanist	person
mayo	substance
mayonnaise	substance
MC	person
McAuliffe	person
McDonald	person
McDonnell	person
McKenzie	person
meals	object
meaning	abstract/inanim
measure	abstract
mechanic	person
mechanician	person
medalist	person
mediator	person
medic	person
medicine	person
medicine	substance/inanim
medium	object
meerkat	animal
meeting	event/inanim
meetups	event
Melbourne	event
member	person
memoirist	person
Men	person
menin	person
mentality	abstract
mercenary	person
mercer	person
merchant	person
Merritt	place
mesmerist	person
message	object
messenger-at-arms	person
Messina	person
metallurgist	person
metalsmith	person
meteorologist	person
meter	object
Method	abstract
methods	abstract
metres	place
metrologist	person
Mets	organization
Mexico	place
mft	person
microbiologist	person
microscope	object
Microsoft	organization
microtome	object
midwife	person
migrant	person
migration	abstract
migration	event
miles	abstract
military	organization
milk	substance
milkmaid	person
mill	place/inanim
miller	person
millions	person
millwright	person
mind	abstract
miner	person
mineralogist	person
minister	person
Ministry	organization
mink	animal
minnow	animal
minstrel	person
minute	time/inanim
minutes	time
misconception	abstract
mishandling	abstract
mission	event
missionary	person
mistakes	abstract
mistresses	person
mix	abstract
mixer	object
mixture	substance
ml	quantity
MMPI	object
mobiles	object
mode	abstract/inanim
model	abstract
model	person
modeler	person
modelmaker	person
modern	place
moestiek	animal
mohel	person
mold	plant
moldmaker	person
mole	animal
molecatcher	person
molosser	animal
molossus	animal
mom	person/female
moment	time
Moments	event
mommy	person/female
money	object
moneylender	person
mongoose	animal
mongrel	animal
moniker	abstract
monk	person
monkey	animal
monks	person
monologist	person
montage	abstract
month	time
months	time
moose	animal
moratorium	event/inanim
more	abstract
morkie	animal
morning	time
morphology	person
mortgager	person
mortician	person
mosquito	animal
moth	animal
mother	person
mother	person/female
motherboard	object/inanim
Motion	organization
motor	object/inanim
motorist	person
mountaineer	person
mouse	animal
mouth	place
movement	abstract
movie	abstract/inanim
movies	abstract
moving	event
muckraker	person
mucuchies	animal
mudi	animal
muezzin	person
mufti	person
muggin	animal
mule	animal
multi-instrumentalist	person
multireedist	person
muralist	person
Museum	place
museums	place
music	abstract
musician	person
musicians	person
musicologist	person
muskox	animal
muskrat	animal
muslin	object
mussel	animal
mustang	animal
my	person
mycologist	person
myself	person
n√©gociant	person
nagarvadhu	person
nailist	person
name	abstract
names	abstract
nanny	person
narrator	person
NASA	organization
nation	place
nationalization	abstract
natives	person
naturalist	person
nature	abstract
navigator	person
need	abstract
needleworker	person
needs	abstract
negotiator	person
Neiafu	place
neighbor	person
neighborhood	place
neighborhoods	place
nematocysts	object
nephrologist	person
net	place
Netherlands	place
network	abstract/inanim
neurobiologist	person
neuroendocrinologist	person
neurologist	person
neurophysiologist	person
neuropsychologist	person
neuroroboticist	person
neuroscientist	person
neurosurgeon	person
neurosurgery	person
News	organization
newscaster	person
newspaper	organization
newspapers	object
newsprint	object
newsreader	person
newt	animal
Newton	person
next	time
nickname	abstract
night	time
nightclubs	place
ninja	person
NJ	place
nobleman	person/male
noblewoman	person/female
nobody	person
nominee	person
nominees	person
non-profit	organization
nonprofit	organization
norrbottenspets	animal
notables	person
notarius	person
notary	person
note	object/inanim
Nov.	time/inanim
novel	object/inanim
novelist	person
novelists	person
November	time
now	time
number	quantity
numbers	quantity
numerologist	person
nun	person/female
nuncio	person
nurse	person
nursemaid	person/female
nutritionist	person
Oakland	place
Oakley	person
Objects	object
oboist	person
observations	abstract
obsession	abstract
obstetrician	person
occasions	event
ocean	place/inanim
oceanographer	person
ocelot	animal
Oct.	time/inanim
October	time
octopus	animal
odontologist	person
of	object
offense	abstract
office	place/inanim
officer	person
official	person
Ohio	place
oil	substance
oilpresser	person
oils	substance
okapi	animal
on	time
oncologist	person
one	abstract
One	object
ones	object
onomastician	person
Onomatopoeia	abstract
ontologist	person
opening	event
operation	event/inanim
operator	person
ophthalmologist	person
opportunities	abstract
opportunity	abstract
opposite	person
optician	person
option	abstract/inanim
options	abstract
optometrist	person
oracle	person
orangutan	animal
orator	person
orbiter	object
orbiters	object
Orchestra	organization
orchestrator	person
Oregon	place
organist	person
organization	abstract
Organization	organization
organization	organization/inanim
organizers	person
orientalist	person
originality	abstract
ornithologist	person
orthodontist	person
orthopaedist	person
orthotist	person
oryx	animal
osteichthyes	animal
osteopath	person
ostrich	animal
other	organization
others	person
otolaryngologist	person
otorhinolaryngologist	person
otter	animal
otterhound	animal
oven	object
over	abstract
Overalls	object
Overpass	object
owl	animal
owners	person
ox	animal
oyster	animal
oz	quantity
ozone	substance
Pacific	person
package	abstract/inanim
package	object/inanim
packer	person
Pad	place
page	object/inanim
page-boy	person/male
pages	object
paint	substance
painter	person
painting	event
pairs	plant
palaeontologist	person
paleoanthropologist	person
paleobiologist	person
paleoclimatologist	person
paleoethnobotanist	person
paleographer	person
paleontologist	person
pallbearer	person
pamphleteer	person
pan	object
pandanus	plant
pandikona	animal
paniolo	person
panter	person
pantry	place
Pants	object
papa	person/male
paper	object
papers	object
paperwork	object
pappom	animal
papyrologist	person
parakeet	animal
paralegal	person
paralympian	person
Paralympics	event
paramedic	person
parameter	abstract/inanim
paraprofessional	person
parapsychologist	person
parasitologist	person
paratrooper	person
parent	person
park	event
Park	place
parking	event
parks	place
parliamentarian	person
parlor	place/inanim
parlormaid	person/female
parole	event/inanim
parrot	animal
parson	person
part	abstract
participants	person
parties	organization
partisan	person
partisanship	abstract
partnership	abstract
partridge	animal
parts	abstract
party	event/inanim
Party	organization
passerine	animal
past	time
pastor	person/male
pastoralist	person
pathologist	person
patience	abstract/inanim
patriarch	person/male
patronage	person
patrons	person
pawnbroker	person
paying	abstract
paymaster	person
payroll	person
peafowl	animal
peanut	plant
peat	substance
peccary	animal
peddler	person
pediatrician	person
pedodontist	person
pekingese	animal
pelican	animal
pen	object
penalty	abstract
penciller	person
penguin	animal
penn	object
penologist	person
people	person
pepperer	person
percent	quantity
perception	abstract
percussionist	person
performance	event/inanim
performances	event
performer	person
perfumer	person
perfusionist	person
period	abstract
periodista	person
periodontist	person
Perkins	person
perlite	substance
peroxide	substance/inanim
person	person
personality	abstract
pesto	object
pests	animal
petiese	person
petrologist	person
phal√®ne	animal
pharmacist	person
pharmacologist	person
pheasant	animal
philanthropist	person
philanthropists	person
philologist	person
philosopher	person
Phoenix	place
phone	object/inanim
phones	object
photo	object
photograph	object
photographer	person
photographers	person
photographs	object
photography	abstract
photojournalist	person
Photos	object
physician	person
physicist	person
physiologist	person
physiotherapist	person
pianist	person
pickler	person
picture	object
pictures	object
piece	object
pig	animal
piled	abstract
pills	object
pilot	person
pimp	person
pioneer	person
pipefitter	person
pirate	person
pitchman	person
pizzerias	place
place	place
places	place
plan	abstract
plane	object
Planetarium	place
planning	abstract
plant	place/inanim
plant	plant
planter	person
Plants	place
plants	plant
plantsman	person
plasterer	person
platypus	animal
play	event
player	person
player-coach	person
playoffs	event
playwright	person
Plaza	place
plenty	place
plot	abstract
plumber	person
plurals	abstract
pm	time
pocket	object
pockets	object
podcaster	person
podiatrist	person
poem	object
poems	object
Poet	person
poetry	abstract/inanim
point	event
Polaroid	object
Polaroids	object
pole	object/inanim
police	organization
policy	abstract
politician	person
politiker	person
poll	event
polling	event
polls	event
pollster	person
pollutants	object
pollution	substance
polymath	person
polytheism	organization
pomeranian	animal
pony	animal
poodle	animal
pope-elect	person/male
popularity	abstract
population	abstract
porcelaine	animal
porcupine	animal
porpoise	animal
port	object/inanim
Port	place
porter	person
Poseidon	person
position	abstract/inanim
positions	abstract
possessions	object
post	object
Post	organization
poster	person
posters	organization
posting	object
postmaster	person
Posts	object
potential	abstract
potter	person
powder	substance
powder	substance/inanim
power	abstract/inanim
preacher	person
precedents	abstract
precentor	person
prediction	abstract
prefect	person
preferences	abstract
prelate	person
presence	abstract
present	abstract
present	object
presenter	person
presents	object
preservation	abstract
preservationist	person
preservatives	substance
President	person
Press	object
Preston	place
price	quantity/inanim
prices	quantity
pride	abstract
priest	person/male
Prieta	event
primate	animal
primatologist	person
princess	animal
printer	person
printmaker	person
prints	object
prior	person
prior	time
prison	place/inanim
problem	abstract/inanim
problems	abstract
proceeds	abstract
process	abstract
proctologist	person
procyon	animal
producer	person
product	object
product	person
production	abstract
products	abstract
professor	person
program	abstract
programmer	person
project	abstract
projectionist	person
projections	object
projects	abstract
promoter	person
prompter	person
pronghorn	animal
proofreader	person
propaganda	abstract
prophet	person
proposal	abstract/inanim
proprietor	person
props	object
prosecutor	person
prospector	person
prosthodontist	person
prostitute	person
protection	abstract
proteins	substance
protopope	person/male
protostrator	person
providing	abstract
psychiarist	person
psychiatrist	person
psychic	person
psychoanalyst	person
psycholinguist	person
psychologist	person
psychotherapist	person
publican	person
publication	event
publicist	person
publisher	person
publishers	person
pudelpointer	animal
pug	animal
puggle	animal
puli	animal
pumi	animal
puppeteer	person
puppy	animal
puroresu	person
purple	abstract
purpose	abstract
put	event
pyncheon	animal
pyrotechnician	person
Python	abstract/inanim
Q	place
quagga	animal
quail	animal
quality	abstract
quality	person
Quantcast	organization
quartermaster	person
question	abstract
questions	abstract
quiet	person
quilter	person
quivermaker	person
quote	abstract/inanim
rabbi	person
rabbit	animal
raccoon	animal
race	abstract/inanim
rack	object
Rack	person
racket	abstract
racketeering	person
raconteur	person
radiobiochemist	person
radiographer	person
radiologist	person
rail	object/inanim
rainbow	object
rajapalayam	animal
randlord	person
range	abstract
rank	abstract/inanim
rapper	person
rappers	person
rat	animal
rat-catcher	person
rate	quantity/inanim
ratio	abstract
rationale	abstract/inanim
rave	event/inanim
raven	animal
reaction	event/inanim
readers	person
reading	abstract
readings	event
realities	abstract
Reality	abstract
reasons	abstract
Rebecca	person
rebel	person
rebuilding	event
receptionist	person
recession	event
recipe	object
recipients	organization
reconstruction	place
record	abstract/inanim
record	object
recorder	person
recovery	event
recruiter	person
rector	person
red	abstract
reduction	abstract
reefs	object
referee	person
references	person
referendum	event/inanim
referent	person
reform	abstract
refrigerator	place
refund	abstract
regent	person
region	place
registrar	person
regulation	abstract
regulations	abstract
reindeer	animal
rejection	abstract
relatives	animal
release	event/inanim
relic	object
religion	organization
religions	organization
remixer	person
remodelling	event/inanim
remora	animal
renovation	event/inanim
rents	abstract
repairman	person/male
report	abstract/inanim
reporters	person
reproduction	abstract
reptile	animal
Repubblica	organization
republic	place/inanim
Republican	person
Republicans	organization
repudiation	abstract
requests	event
rescuer	person
researcher	person
researchers	person
resident	person
residents	person
resource	abstract
resources	abstract
respect	abstract
response	abstract
rest	abstract
restaurant	place
restaurants	place
restaurateur	person
restriction	abstract
result	abstract/inanim
Results	object
retailer	person
retailers	place
retirement	event
retreat	event
return	event
revelation	abstract
revenue	object
reverand	person
review	event
Revolutionary	event
revolutionary	person
revolve	abstract
reward	abstract
rheumatologist	person
rhinoceros	animal
Rhodes	person
ribbon	object/inanim
riches	abstract
rigger	person
right	abstract
rights	abstract
ring	abstract/inanim
ring	object/inanim
ringmaster	person
rise	event
risk	abstract/inanim
rival	object
rivalries	abstract
river	place
riveter	person
road	place
roadshow	event/inanim
roadways	place
robber	person
roboticist	person
Rockridge	place
rocks	object
rodent	animal
role	abstract
rollerblader	person
roofer	person
rook	animal
room	object
rooms	place
roots	abstract
ropemaker	person
rosewater	substance
rottweiler	animal
round	event/inanim
route	abstract
route	place
rower	person
Rubell	person
rule	abstract
rules	abstract
ruling	event
runemaster	person
runner	person
rush	abstract/inanim
ryeland	animal
s	abstract
S&M	abstract
s/he	person
sacrifice	abstract
safari	abstract
safety	abstract/inanim
sagmatias	animal
sailmaker	person
sailor	person
salad	object
salamander	animal
salaryman	person/male
sale	event/inanim
salesman	person/male
salesperson	person
saleswoman	person/female
salonnieres	person
salons	place
saloon	place
salt	substance
saluki	animal
sample	object
samples	object
samurai	person/male
sanction	abstract
sandwiches	object
sapsali	animal
sarplaninac	animal
Sarvis	person
satirist	person
Saturday	time
Saturn	person
saucier	person
sawfiler	person
sawyer	person
saxophonist	person
Scarne	object
scenario	event
scenarios	event
scene	abstract
scenographer	person
scent	abstract
schapendoes	animal
schauspieler	person
schedules	abstract
schillerst√∂vare	animal
schipperke	animal
schnoodle	animal
scholar	person
scholar-official	person
school	organization
scientist	person
scientists	person
Scientology	organization
scope	object
scorpion	animal
scout	person
screen	object
screenwriter	person
screw	object
screws	object
scribe	person
scrutiny	abstract/inanim
sculptor	person
Sea	place
seabird	animal
seaman	person/male
seamstress	person/female
season	event
season	time
seating	abstract/inanim
seats	object
Seattle	place
second	event
seconds	time
secretary	person
section	object
secularism	abstract/inanim
security	abstract
see	abstract
seed	plant
Seeds	plant
seismologist	person
selection	abstract
selenographer	person
selfie	object
Senator	person
sense	abstract
sensei	person
Sep.	time/inanim
September	time
sequence	abstract
sergigamez	person
server	object
server	object/inanim
server	person
service	abstract/inanim
Service	organization
serviceman	person/male
services	abstract
serving	quantity
servings	abstract
set	abstract/inanim
sets	plant
setting	abstract/inanim
setting	place/inanim
settlement	event/inanim
settlement	place/inanim
settler	person
several	abstract
sexton	person
ShakataGaNai	person
sham	abstract
shaman	person
share	abstract
shark	animal
she	person
Shea	place
sheep	animal
sheet	object
sheltered	place
sheltie	animal
shepherd	person
sheriff	person
shield	object/inanim
shih-poo	animal
shihainin	person
shihan	person
ship-owner	person
shipping	abstract
shipwright	person
shirt	object
shirts	object
shochet	person
shoemaker	person
shoes	object
shopkeeper	person
shopping	event
shops	place
shore	place
shores	place
shortfalls	abstract
Shorts	object
shot	object
shots	object
shoulders	object
show	abstract/inanim
show	event/inanim
showgirl	person/female
showman	person/male
showrunner	person
shrew	animal
shuttle	object
shuttles	object
side	abstract
sideman	person
sides	object
sieve	object
sigger	person
sighthound	animal
sign	abstract
signalman	person
signing	event
signwriter	person
silversmith	person
Simmons	person
Simon	person
simplification	abstract
simply	event
Simpson	abstract
simulators	object
singer	person
singer-songwriter	person
sinologist	person
site	place
sites	place
six	person
sixties	time
size	abstract
sizes	quantity
skateboarder	person
sketchbook	object/inanim
skewer	object
skier	person
skills	abstract
skin	object/inanim
Skinner	person
skirmish	event
skirmisher	person
skirts	object
Skittled	substance
Skittles	object
skunk	animal
skyline	object
slater	person
slave	person
slavedriver	person
sleeves	object
slices	object
slides	object
sloeber	animal
sloth	animal
sloughi	animal
smelter	person
smidge	quantity
smidgen	quantity
Smithsonian	place
smock	object/inanim
smoker	person
smugness	abstract
snacks	object
snail	animal
snake	animal
snipe	animal
sniper	person
snippet	abstract
snow	substance
snowboarder	person
SNY	organization
So	event
soaper	person
socialism	abstract/inanim
socialite	person
sociologist	person
soda	substance
sodium	substance/inanim
sofer	person
softener	object
software	abstract
soil	substance
sold	event
soldier	person
solicitor	person
solution	abstract
solution	substance
Some	abstract
some	plant
somebody	person
Someone	person
something	object
sommelier	person
son	person/male
songwriter	person
sorcerer	person/male
sorghum	plant
sort	abstract
sotalia	animal
soubrette	person
soul	abstract
sound	person
soundman	person/male
Soup	object
sourness	abstract
South	place
soybean	plant
space	place
spaces	abstract
sparrow	animal
spartan	person
species	animal
specimen	object
specimens	object
spectrum	abstract
speculator	person
speechwriter	person
speed	abstract/inanim
speeds	abstract
spelunker	person
spending	abstract
spice	object
spider	animal
spinoff	object
Spitfire	event
splash	abstract
spokesperson	person
spokeswoman	person/female
sports	abstract
springbok	animal
Springs	place
sprouts	plant
spy	person
spymaster	person
Square	place
squid	animal
squirrel	animal
St.	place
stabyhoun	animal
Stadium	place
staff	person
stagehand	person
staircase	place/inanim
stalk	plant
stalker	person
stallion	animal
stand	abstract
stand-in	person
stanza	object
star	object
star	person
stars	person
start	event
State	place
statement	abstract
States	place
statesman	person/male
Station	place
stations	place
statistician	person
status	abstract
steelworker	person
steersman	person/male
Stein	person
stem	plant
stems	plant
stenella	animal
stenographer	person
step	event
steps	abstract
stereographer	person
stevedore	person
steward	person
stipulation	abstract
stockbroker	person
stockholder	person
stockman	person/male
stone	object/inanim
stone	substance/inanim
stonecutter	person
stonemason	person
Store	place
storefronts	place
storekeeper	person
stores	place
storm	event/inanim
story	abstract/inanim
story-teller	person
strainer	object
stranger	person
straps	object
strategist	person
strawberry	substance
Streep	person
street	place
streets	place
string	place
strings	abstract
stripper	person
strongman	person/male
strongwoman	person/female
structure	abstract
structures	abstract
student	person
students	person/plural
studied	abstract
studies	event
Studio	organization
studio	place
study	event
stuff	object
style	abstract
stylist	person
styrmann	person
sub-inspector	person
success	abstract
successes	abstract
suffix	abstract
sugar	substance
suit	abstract/inanim
suit	object/inanim
sum	quantity/inanim
summer	time
sunbathing	event
sunlight	substance
sunshine	substance
superintendent	person
superiors	person
supermarkets	place
supermodel	person/female
superstores	place
supplies	abstract
supply	abstract
surfer	person
surgeon	person
surveillance	person
surveyor	person
swallow	animal
swan	animal
sweeper	person
swimmer	person
swineherd	person
swordsmith	person
synthesist	person
syrup	object
sysop	person
system	abstract
table	object
tables	object
tactician	person
tag	abstract
taigan	animal
tail	object/inanim
tailor	person
Taking	event
talk	event
Tan	person
tanager	animal
tanner	person
TAOM	event
tape	object
tapir	animal
tarento	person
target	abstract/inanim
taste	abstract
Tax	abstract
taxidermist	person
taxonomist	person
tea	substance
teacher	person
team	organization
teams	organization
teamster	person
tears	substance
teaspoons	substance
technician	person
technique	abstract
technologist	person
technology	abstract
telegram	object
telegraphist	person
televangelist	person
telomian	animal
Temescal	place
temperature	substance
temperatures	abstract
temple	place
temples	object
temptations	abstract
tendrils	plant
Tennessee	place
tentmaker	person
tenure	abstract
term	abstract
Terrace	place
terror	abstract
terrorism	abstract
terrorist	person
tervuren	animal
test	abstract
tester	person
Teterboro	place
Texans	person
Texas	place
Thailand	place
Thais	person
Thank	event
That	abstract
thatcher	person
The	place
Theater	place
theaters	place
theatre	place
theft	abstract
theft	event
then	event
theologian	person
theoretician	person
theory	abstract/inanim
there	place
thief	person
thimbler	person
thing	abstract
things	abstract
think	person
Thompson	person
thoroughbred	animal
those	object/plural
those	person/plural
thought	abstract
thousands	person
threat	abstract
throughout	time
thunderstorms	abstract
Thursday	time
ties	object
tiger	animal
tiles	abstract
time	time
Times	organization
times	time
timpanist	person
tinker	person
tinner	person
tinsmith	person
tires	object
title	abstract
toad	animal
tobacconist	person
Today	time
toiletries	object
Tom	person
Tongatapu	place
tontechniker	person
tool	object
toolmaker	person
tools	object
top	place/inanim
topics	abstract
toponymist	person
tops	object
torero	person
tornjak	animal
torrent	abstract
torrent	quantity
torturer	person
tosa	animal
toshiyori	person
touches	person
touchstones	person
tourism	person
Tournament	event
towels	object
town	place
toxicologist	person
trade	abstract
trader	person
tradesman	person
Traffic	abstract
trails	place
trainer	object
trainer	person
trakehner	animal
transfer	abstract
transfer	event
transit	organization
transition	event
translator	person
transportation	abstract
trapper	person
travel	abstract
traveler	person
traveller	person
tray	object
treasures	object
treatment	abstract/inanim
treatment	event/inanim
tree	plant
trees	object
triathlete	person
tribologist	person
trichology	person
tricks	abstract
trip	event
trips	event
trombonist	person
trumpeter	person
tube	object/inanim
tucuxi	animal
Tuesday	time
tulku	person
turkey	animal
turmoil	abstract
turner	person
turntablist	person
turtle	animal
tutor	person
Twitter	abstract/inanim
Twitter	organization
two	abstract
type	abstract/inanim
typefounder	person
types	place
typesetting	person
tyrant	person
U.S.	place
uda	animal
ufologist	person
ufology	person
UK	place
ulama	person
umpire	person
uncertainty	abstract
uncle	person/male
under	abstract
Underground	organization
undernourishment	abstract
understanding	abstract
union	organization
unit	object/inanim
universities	organization
university	organization
university	place
unknowns	person
unused	object
update	event/inanim
upholsterer	person
Uptown	place
urbanization	event/inanim
urge	abstract
urologist	person
ursari	person
US	place
USA	place
use	abstract
used	event
user	person
users	person
usher	person
USI	organization
Using	event
usurper	person
utensil	object/inanim
utonagan	animal
valet	person
valley	place/inanim
value	abstract
vanilla	substance
varieties	abstract
Vava‚Äôu	place
Vava\'u	place
vedette	person
Vegas	place
vegetation	plant
vehicle	object/inanim
veins	plant
vendor	person
vendors	person
ventriloquist	person
veranda	place/inanim
vermiculite	substance
versions	abstract
vertebrate	animal
veteran	person
vibe	abstract
vibraphonist	person
Victory	object
vicu√±a	animal
video	object
videographer	person
views	abstract
viking	person
village	place
vinegar	substance
violinist	person
violinmaker	person
violist	person
viperidae	animal
Virginia	place
virologist	person
virtuoso	person
vision	abstract
visionary	person
visitor	person
Visitors	person
visits	abstract
viverridae	animal
vizsla	animal
vj	person
vlogger	person
vodka	substance
Vogel	abstract
Vogelaviatiolap	abstract
Vogelaviatiolaps	abstract
Voice	object
volcanologist	person
volunteer	person
volunteers	person
Vostok	object
vote	abstract/inanim
Voters	person
vouchers	object
vowel	object
vowels	abstract
vulnerabilities	abstract
vulture	animal
wagonmaker	person
wai	event
waiing	event
wakeboarder	person
walk	event
walking	event
walks	event
wall	object
Walmart	organization
walrus	animal
want	abstract
war	event
warehouseman	person/male
warehouses	place
Warhol	person
warlord	person
warming	event
warrior	person
wash	abstract
washboard	object
Washington	person
waste	substance/inanim
watchmaker	person
watchman	person/male
Water	person
water	substance
waterbuck	animal
Waters	person
waters	place/inanim
wats	place
way	abstract
wealth	abstract
weapon-smith	person
wear	abstract
wearing	abstract
weasel	animal
weathercaster	person
weaver	person
web	abstract
webmaster	person
website	place
Weehawken	place
week	time
weekend	time
weightlifter	person
weimaraner	animal
welder	person
west	place
Westerners	person
wetterhoun	animal
whale	animal
whales	animal
What	abstract
what	object
wheat	plant
wheelwright	person
whippet	animal
whistleblower	person
whitesmith	person
Whitman	person
wholphin	animal
Wicca	organization
widget	abstract/inanim
wife	person/female
wig	object
Wiki	object
wikiHow	place
wikiLove	abstract
Wikinews	organization
Wikipedia	organization
wildcat	animal
wildcatter	person
wildebeest	animal
Wilkins	person
willow	animal
window	object
winds	place
winemaker	person
Winning	event
winston	animal
winter	time
wolf	animal
wolverine	animal
wolves	animal
woman	person/female
wombat	animal
Women	person
wonder	abstract
wonderworker	person
woodcutter	person
woodsman	person/male
woodturner	person
woodworker	person
wooler	person
word	abstract
words	abstract
work	abstract
worker	person
workman	person/male
works	object
world	place
worldview	abstract
worm	animal
worship	abstract
worshippers	person
worth	object
wrangler	person
wrap	object
wren	animal
wrestler	person
writer	person
writings	abstract/plural
xnewspaper	object
XP	object
xylophonist	person
yachties	object
yachts	object
yak	animal
yard	place
year	time
years	time/inanim
yeoman	person
yield	object
yields	object
yodeler	person
York	place
YouTube	organization
youtuber	person
yoyobichi	person
zamindar	person
zebu	animal
Zeitgeist	abstract
Zero	place
Zeus	event
zookeeper	person
zoologist	person
\$	quantity/inanim
\'scopes	object
